1111111111111
1000001 110001
100001  100110001
1000001  10000001
1000000110001
11111111
